{
  "mapa": [
    [6,6,6,6,6,7,7,6,6,6,7,7,6,6,6,7,7,6,6,6,7,7,6,6,6],
    [6,0,0,0,0,0,0,0,0,0,0,0,0,0,0,0,0,0,0,0,0,0,0,22,6],
    [6,0,0,0,12,0,0,0,0,12,0,0,0,0,12,0,0,0,0,12,0,0,0,0,6],
    [6,0,0,14,15,18,0,0,14,15,18,0,0,14,15,18,0,0,14,15,18,0,0,0,6],
    [6,0,0,0,13,0,0,0,0,13,0,0,0,0,13,0,0,0,0,13,0,0,0,0,6],
    [6,0,0,0,0,0,0,0,0,0,0,0,0,0,0,0,0,0,0,0,0,0,0,0,6],
    [6,0,0,0,0,0,0,0,0,0,0,0,0,0,0,0,0,0,0,0,0,0,0,0,6],
    [6,0,0,0,12,0,0,0,0,12,0,0,0,0,12,0,0,0,0,12,0,0,0,0,6],
    [6,19,0,14,15,18,0,0,14,15,18,0,0,14,15,18,0,0,14,15,18,0,0,0,6],
    [6,0,0,0,13,0,0,0,0,13,0,0,0,0,13,0,0,0,0,13,0,0,0,0,6],
    [6,0,0,0,0,0,0,0,0,0,0,0,0,0,0,0,0,0,0,0,0,0,0,0,6],
    [6,0,0,0,0,0,0,0,0,0,0,0,0,0,0,0,0,0,0,0,0,0,0,0,6],
    [6,0,0,0,12,0,0,0,0,12,0,0,0,0,12,0,0,0,0,12,0,0,0,0,6],
    [6,0,0,14,15,18,0,0,14,15,18,0,0,14,15,18,0,0,14,15,18,0,0,0,6],
    [6,0,0,0,13,0,0,0,0,13,0,0,0,0,13,0,0,0,0,13,0,0,0,0,6],
    [6,0,0,0,0,0,0,0,0,0,0,0,0,0,0,0,0,0,0,0,0,0,0,0,6],
    [6,0,0,0,0,0,0,0,0,0,0,0,0,0,0,0,0,0,0,0,0,0,0,0,6],
    [6,6,6,6,6,6,10,6,6,6,6,6,10,6,6,6,6,6,10,6,6,6,6,6,6]
  ],
  "colisiones": [
    [1,1,1,1,1,1,1,1,1,1,1,1,1,1,1,1,1,1,1,1,1,1,1,1,1],
    [1,0,0,0,0,0,0,0,0,0,0,0,0,0,0,0,0,0,0,0,0,0,0,0,1],
    [1,0,0,0,1,0,0,0,0,1,0,0,0,0,1,0,0,0,0,1,0,0,0,0,1],
    [1,0,0,1,1,0,0,0,1,1,0,0,0,1,1,0,0,0,1,1,0,0,0,0,1],
    [1,0,0,0,1,0,0,0,0,1,0,0,0,0,1,0,0,0,0,1,0,0,0,0,1],
    [1,0,0,0,0,0,0,0,0,0,0,0,0,0,0,0,0,0,0,0,0,0,0,0,1],
    [1,0,0,0,0,0,0,0,0,0,0,0,0,0,0,0,0,0,0,0,0,0,0,0,1],
    [1,0,0,0,1,0,0,0,0,1,0,0,0,0,1,0,0,0,0,1,0,0,0,0,1],
    [1,0,0,1,1,0,0,0,1,1,0,0,0,1,1,0,0,0,1,1,0,0,0,0,1],
    [1,0,0,0,1,0,0,0,0,1,0,0,0,0,1,0,0,0,0,1,0,0,0,0,1],
    [1,0,0,0,0,0,0,0,0,0,0,0,0,0,0,0,0,0,0,0,0,0,0,0,1],
    [1,0,0,0,0,0,0,0,0,0,0,0,0,0,0,0,0,0,0,0,0,0,0,0,1],
    [1,0,0,0,1,0,0,0,0,1,0,0,0,0,1,0,0,0,0,1,0,0,0,0,1],
    [1,0,0,1,1,0,0,0,1,1,0,0,0,1,1,0,0,0,1,1,0,0,0,0,1],
    [1,0,0,0,1,0,0,0,0,1,0,0,0,0,1,0,0,0,0,1,0,0,0,0,1],
    [1,0,0,0,0,0,0,0,0,0,0,0,0,0,0,0,0,0,0,0,0,0,0,0,1],
    [1,0,0,0,0,0,0,0,0,0,0,0,0,0,0,0,0,0,0,0,0,0,0,0,1],
    [1,1,1,1,1,1,1,1,1,1,1,1,1,1,1,1,1,1,1,1,1,1,1,1,1]
    ],

"zonas": [
    { "x": 1, "y": 8, "url": "https://drive.google.com/file/d/16g_9pmcC9jSSJUcV0Vyveyf74ndRkkkT/view?usp=sharing" },
    { "x": 5, "y": 3, "url": "https://drive.google.com/file/d/1D8Y8a5UVLVNHNMwhAMKoiyjLO4MXoVoU/view?usp=sharing" },
    { "x": 23, "y": 1, "url": " https://pablolu2024.github.io/Biblioteca/" }
  ]

}