{
  "mapa": [
    [5,25,26,27,28,29,30,31,32,33,34,35,25,26,27,28,29,30,31,32,33,34,35,22,5],
    [5,0,0,0,0,0,0,0,0,0,0,0,0,0,0,0,0,0,0,0,0,0,0,0,5],
    [5,0,0,0,12,0,0,0,0,12,0,0,0,0,12,0,0,0,0,12,0,0,0,0,5],
    [5,0,0,14,15,18,0,0,14,15,18,0,0,14,15,18,0,0,14,15,18,0,0,0,5],
    [5,0,0,0,13,0,0,0,0,13,0,0,0,0,13,0,0,0,0,13,0,0,0,0,5],
    [5,25,26,27,28,29,30,31,32,33,34,35,25,26,27,28,29,30,31,32,33,34,35,0,5],
    [5,0,0,0,0,0,0,0,0,0,0,0,0,0,0,0,0,0,0,0,0,0,0,0,5],
    [5,0,0,0,12,0,0,0,0,12,0,0,0,0,12,0,0,0,0,12,0,0,0,0,5],
    [5,0,0,14,15,18,0,0,14,15,18,0,0,14,15,18,0,0,14,15,18,0,0,0,5],
    [5,0,0,0,13,0,0,0,0,13,0,0,0,0,13,0,0,0,0,13,0,0,0,0,5],
    [5,36,37,38,39,40,41,42,43,44,45,46,36,37,38,39,40,41,42,43,44,45,46,0,5],
    [5,48,49,0,0,0,0,0,0,0,0,0,0,0,0,0,0,0,0,0,0,0,0,0,5],
    [5,0,0,0,12,0,0,0,0,12,0,0,0,0,12,0,0,0,0,12,0,0,0,0,5],
    [5,0,0,14,15,18,0,0,14,15,18,0,0,14,15,18,0,0,14,15,18,0,0,0,5],
    [5,0,0,0,13,0,0,0,0,13,0,0,0,0,13,0,0,0,0,13,0,0,0,0,5],
    [5,0,0,0,0,0,0,0,0,0,0,0,0,0,0,0,0,0,0,0,0,0,0,0,5],
    [5,0,0,0,0,0,0,0,0,0,0,0,0,0,0,0,0,0,0,0,0,0,0,0,5],
    [5,36,37,38,39,40,41,42,43,44,45,46,36,37,38,39,40,41,42,43,44,45,46,10,5]
  ],
  "colisiones": [
    [1,1,1,1,1,1,1,1,1,1,1,1,1,1,1,1,1,1,1,1,1,1,1,1,1],
    [1,0,0,0,0,0,0,0,0,0,0,0,0,0,0,0,0,0,0,0,0,0,0,0,1],
    [1,0,0,0,1,0,0,0,0,1,0,0,0,0,1,0,0,0,0,1,0,0,0,0,1],
    [1,0,0,1,1,0,0,0,1,1,0,0,0,1,1,0,0,0,1,1,0,0,0,0,1],
    [1,0,0,0,1,0,0,0,0,1,0,0,0,0,1,0,0,0,0,1,0,0,0,0,1],
    [1,1,1,1,1,1,1,1,1,1,1,1,1,1,1,1,1,1,1,1,1,1,1,0,1],
    [1,0,0,0,0,0,0,0,0,0,0,0,0,0,0,0,0,0,0,0,0,0,0,0,1],
    [1,0,0,0,1,0,0,0,0,1,0,0,0,0,1,0,0,0,0,1,0,0,0,0,1],
    [1,0,0,1,1,0,0,0,1,1,0,0,0,1,1,0,0,0,1,1,0,0,0,0,1],
    [1,0,0,0,1,0,0,0,0,1,0,0,0,0,1,0,0,0,0,1,0,0,0,0,1],
    [1,1,1,1,1,1,1,1,1,1,1,1,1,1,1,1,1,1,1,1,1,1,1,0,1],
    [1,1,1,0,0,0,0,0,0,0,0,0,0,0,0,0,0,0,0,0,0,0,0,0,1],
    [1,0,0,0,1,0,0,0,0,1,0,0,0,0,1,0,0,0,0,1,0,0,0,0,1],
    [1,0,0,1,1,0,0,0,1,1,0,0,0,1,1,0,0,0,1,1,0,0,0,0,1],
    [1,0,0,0,1,0,0,0,0,1,0,0,0,0,1,0,0,0,0,1,0,0,0,0,1],
    [1,0,0,0,0,0,0,0,0,0,0,0,0,0,0,0,0,0,0,0,0,0,0,0,1],
    [1,0,0,0,0,0,0,0,0,0,0,0,0,0,0,0,0,0,0,0,0,0,0,0,1],
    [1,1,1,1,1,1,1,1,1,1,1,1,1,1,1,1,1,1,1,1,1,1,1,1,1]
    ],

"zonas": [
    { "x": 1, "y": 12, "url": "https://pablolu2024.github.io/Biblioteca/" }
    
  ]

}