{
  "mapa": [
    [4,171,172,173,174,161,162,171,172,173,174,155,156,163,164,7,7,4,157,158,7,7,4,4,4],
    [4,196,197,198,199,186,187,196,197,198,199,180,181,188,189,144,144,144,182,183,144,144,144,154,4],
    [4,144,144,144,66,144,144,144,144,66,144,144,144,144,66,144,144,144,144,66,144,144,144,179,4],
    [4,144,144,67,150,177,144,144,67,150,144,144,144,67,150,144,144,144,67,150,144,144,144,144,4],
    [4,144,144,144,68,144,144,144,144,68,144,144,144,144,68,144,144,144,144,68,144,144,144,144,4],
    [4,144,144,144,144,144,144,144,144,144,144,144,144,144,144,144,144,144,144,144,144,144,144,144,4],
    [4,144,144,144,144,144,144,144,144,144,144,144,144,144,144,144,144,144,144,144,144,144,144,144,4],
    [4,144,144,144,12,144,144,144,144,12,144,144,144,144,12,144,144,144,144,12,144,144,144,144,4],
    [4,19,144,14,152,144,144,144,14,152,144,144,144,14,152,144,144,144,14,152,144,144,144,144,4],
    [4,144,144,144,13,144,144,144,144,13,144,144,144,144,13,144,144,144,144,13,144,144,144,144,4],
    [4,144,144,144,144,144,144,144,144,144,144,144,144,144,144,144,144,144,144,144,144,144,144,144,4],
    [4,144,144,144,144,144,144,144,144,144,144,144,144,144,144,144,144,144,144,144,144,144,144,144,4],
    [4,144,144,77,78,144,144,144,79,80,144,144,144,144,72,144,144,144,144,69,144,144,144,144,4],
    [4,144,144,144,144,144,144,144,144,144,144,144,144,73,151,144,144,144,70,152,144,144,144,144,4],
    [4,144,144,93,94,144,144,144,97,98,144,144,144,144,74,144,144,144,144,71,144,144,144,144,4],
    [4,144,144,144,144,144,144,144,144,144,144,144,144,144,144,144,144,144,144,144,144,144,144,144,4],
    [4,144,144,144,144,144,144,144,144,144,144,144,144,144,144,144,144,144,144,144,144,144,144,144,4],
    [4,4,4,4,4,4,10,4,4,4,4,4,10,4,4,4,4,4,10,4,4,4,4,4,4]
  ],
  "colisiones": [
    [1,1,1,1,1,1,1,1,1,1,1,1,1,1,1,1,1,1,1,1,1,1,1,1,1],
    [1,0,0,0,0,0,0,0,0,0,0,0,0,0,0,0,0,0,0,0,0,0,0,0,1],
    [1,0,0,0,1,0,0,0,0,1,0,0,0,0,1,0,0,0,0,1,0,0,0,0,1],
    [1,0,0,1,1,0,0,0,1,1,0,0,0,1,1,0,0,0,1,1,0,0,0,0,1],
    [1,0,0,0,1,0,0,0,0,1,0,0,0,0,1,0,0,0,0,1,0,0,0,0,1],
    [1,0,0,0,0,0,0,0,0,0,0,0,0,0,0,0,0,0,0,0,0,0,0,0,1],
    [1,0,0,0,0,0,0,0,0,0,0,0,0,0,0,0,0,0,0,0,0,0,0,0,1],
    [1,0,0,0,1,0,0,0,0,1,0,0,0,0,1,0,0,0,0,1,0,0,0,0,1],
    [1,0,0,1,1,0,0,0,1,1,0,0,0,1,1,0,0,0,1,1,0,0,0,0,1],
    [1,0,0,0,1,0,0,0,0,1,0,0,0,0,1,0,0,0,0,1,0,0,0,0,1],
    [1,0,0,0,0,0,0,0,0,0,0,0,0,0,0,0,0,0,0,0,0,0,0,0,1],
    [1,0,0,0,0,0,0,0,0,0,0,0,0,0,0,0,0,0,0,0,0,0,0,0,1],
    [1,0,0,1,1,0,0,0,1,1,0,0,0,0,1,0,0,0,0,1,0,0,0,0,1],
    [1,0,0,0,0,0,0,0,0,0,0,0,0,1,1,0,0,0,1,1,0,0,0,0,1],
    [1,0,0,1,1,0,0,0,1,1,0,0,0,0,1,0,0,0,0,1,0,0,0,0,1],
    [1,0,0,0,0,0,0,0,0,0,0,0,0,0,0,0,0,0,0,0,0,0,0,0,1],
    [1,0,0,0,0,0,0,0,0,0,0,0,0,0,0,0,0,0,0,0,0,0,0,0,1],
    [1,1,1,1,1,1,0,1,1,1,1,1,1,1,1,1,1,1,1,1,1,1,1,1,1]
    ],

"zonas": [
    { "x": 1, "y": 8,"tipo": "url", "url": "https://onedrive.live.com/embed?resid=137F5EF2D7F2BD1C%212026&authkey=!AKYewE9OKjebnIc" },
    { "x": 5, "y": 3,"tipo": "url", "url": " https://pablolu2024.github.io/jurasico/" },
    { "x": 23, "y": 1,"tipo": "url", "url": "https://zeno.fm/radio/ochenterosriobamba/" },
{
      "x": 6,
      "y": 17,
      "tipo": "mapa",
      "destino": "maps/mapa1.json",
      "xInicio": 12,
      "yInicio": 16
    }
  ]

}