{
  "mapa": [
    [27,350,351,438,439,440,441,438,439,440,441,442,443,163,164,429,430,431,432,433,434,27,27,27,27],
    [27,375,376,463,464,465,466,463,464,465,466,467,468,188,189,454,455,456,457,458,459,18,18,367,27],
    [27,18,18,18,48,18,18,18,18,48,18,18,18,18,48,18,18,18,18,48,18,18,18,392,27],
    [27,18,18,49,209,291,18,18,49,209,18,18,18,49,209,18,18,18,49,209,18,18,18,18,27],
    [27,18,18,18,50,18,18,18,18,50,18,18,18,18,50,18,18,18,18,50,18,18,18,18,27],
    [27,18,18,18,18,18,18,18,18,18,18,18,18,18,18,18,18,18,18,18,18,18,18,18,27],
    [27,18,18,18,18,18,18,18,18,18,18,18,18,18,18,18,18,18,18,18,18,18,18,18,27],
    [27,18,18,18,63,18,18,18,18,63,18,18,18,18,63,18,18,18,18,63,18,18,18,18,27],
    [27,352,18,64,217,18,18,18,64,217,18,18,18,64,217,18,18,18,64,217,18,18,18,18,27],
    [27,18,18,18,65,18,18,18,18,65,18,18,18,18,65,18,18,18,18,65,18,18,18,18,27],
    [27,18,18,18,18,18,18,18,18,18,18,18,18,18,18,18,18,18,18,18,18,18,18,18,27],
    [27,18,18,18,18,18,18,18,18,18,18,18,18,18,18,18,18,18,18,18,18,18,18,18,27],
    [27,18,18,77,78,18,18,18,79,80,18,18,18,18,60,18,18,18,18,60,18,18,18,18,27],
    [27,18,18,18,18,18,18,18,18,18,18,18,18,61,213,18,18,18,61,213,18,18,18,18,27],
    [27,18,18,93,94,18,18,18,97,98,18,18,18,18,62,18,18,18,18,62,18,18,18,18,27],
    [27,18,18,18,18,18,18,18,18,18,18,18,18,18,18,18,18,18,18,18,18,18,18,18,27],
    [27,18,18,18,18,18,18,18,18,18,18,18,18,18,18,18,18,18,18,18,18,18,18,18,27],
    [27,27,27,27,27,27,482,27,27,27,27,27,482,27,27,27,27,27,482,27,27,27,27,27,27]
  ],
  "colisiones": [
    [1,1,1,1,1,1,1,1,1,1,1,1,1,1,1,1,1,1,1,1,1,1,1,1,1],
    [1,0,0,0,0,0,0,0,0,0,0,0,0,0,0,0,0,0,0,0,0,0,0,0,1],
    [1,0,0,0,1,0,0,0,0,1,0,0,0,0,1,0,0,0,0,1,0,0,0,0,1],
    [1,0,0,1,1,0,0,0,1,1,0,0,0,1,1,0,0,0,1,1,0,0,0,0,1],
    [1,0,0,0,1,0,0,0,0,1,0,0,0,0,1,0,0,0,0,1,0,0,0,0,1],
    [1,0,0,0,0,0,0,0,0,0,0,0,0,0,0,0,0,0,0,0,0,0,0,0,1],
    [1,0,0,0,0,0,0,0,0,0,0,0,0,0,0,0,0,0,0,0,0,0,0,0,1],
    [1,0,0,0,1,0,0,0,0,1,0,0,0,0,1,0,0,0,0,1,0,0,0,0,1],
    [1,0,0,1,1,0,0,0,1,1,0,0,0,1,1,0,0,0,1,1,0,0,0,0,1],
    [1,0,0,0,1,0,0,0,0,1,0,0,0,0,1,0,0,0,0,1,0,0,0,0,1],
    [1,0,0,0,0,0,0,0,0,0,0,0,0,0,0,0,0,0,0,0,0,0,0,0,1],
    [1,0,0,0,0,0,0,0,0,0,0,0,0,0,0,0,0,0,0,0,0,0,0,0,1],
    [1,0,0,1,1,0,0,0,1,1,0,0,0,0,1,0,0,0,0,1,0,0,0,0,1],
    [1,0,0,0,0,0,0,0,0,0,0,0,0,1,1,0,0,0,1,1,0,0,0,0,1],
    [1,0,0,1,1,0,0,0,1,1,0,0,0,0,1,0,0,0,0,1,0,0,0,0,1],
    [1,0,0,0,0,0,0,0,0,0,0,0,0,0,0,0,0,0,0,0,0,0,0,0,1],
    [1,0,0,0,0,0,0,0,0,0,0,0,0,0,0,0,0,0,0,0,0,0,0,0,1],
    [1,1,1,1,1,1,0,1,1,1,1,1,1,1,1,1,1,1,1,1,1,1,1,1,1]
    ],

"zonas": [
    { "x": 1, "y": 8,"tipo": "url", "url": "https://onedrive.live.com/embed?resid=137F5EF2D7F2BD1C%212026&authkey=!AKYewE9OKjebnIc" },
    { "x": 5, "y": 3,"tipo": "url", "url": "https://pablolu2024.github.io/laberinto8/" },
    { "x": 23, "y": 1,"tipo": "url", "url": "https://zeno.fm/radio/ochenterosriobamba/" },
{
      "x": 6,
      "y": 17,
      "tipo": "mapa",
      "destino": "maps/mapa1.json",
      "xInicio": 12,
      "yInicio": 16
    }
  ]


}
