{
  "mapa": [
    [30,30,30,30,30,479,479,30,30,30,479,479,30,30,30,479,479,30,30,30,479,479,30,30,30],
    [30,258,0,0,0,0,0,0,0,0,0,0,0,0,0,0,0,0,0,0,0,0,0,126,30],
    [30,283,0,0,48,0,0,0,0,48,0,0,0,0,48,0,0,0,0,48,0,0,0,151,30],
    [30,0,0,49,209,267,0,0,49,209,267,0,0,49,209,267,0,0,49,209,267,0,0,0,30],
    [30,0,0,0,50,0,0,0,0,50,0,0,0,0,50,0,0,0,0,50,0,0,0,0,30],
    [30,0,0,0,0,0,0,0,0,0,0,0,0,0,0,0,0,0,0,0,0,0,0,0,30],
    [30,0,0,0,0,0,0,0,0,0,0,0,0,0,0,0,0,0,0,0,0,0,0,0,30],
    [30,0,0,0,63,0,0,0,0,63,0,0,0,0,63,0,0,0,0,63,0,0,0,0,30],
    [30,232,0,64,217,267,0,0,64,217,267,0,0,64,217,267,0,0,64,217,267,0,0,0,30],
    [30,0,0,0,65,0,0,0,0,65,0,0,0,0,65,0,0,0,0,65,0,0,0,0,30],
    [30,0,0,0,0,0,0,0,0,0,0,0,0,0,0,0,0,0,0,0,0,0,0,0,30],
    [30,0,0,0,0,0,0,0,0,0,0,0,0,0,0,0,0,0,0,0,0,0,0,0,30],
    [30,0,0,0,60,0,0,0,0,60,0,0,0,0,60,0,0,0,0,60,0,0,0,0,30],
    [30,0,0,61,213,267,0,0,61,213,267,0,0,61,213,267,0,0,61,213,291,0,0,0,30],
    [30,0,0,0,62,0,0,0,0,62,0,0,0,0,62,0,0,0,0,62,0,0,0,0,30],
    [30,0,0,0,0,0,0,0,0,0,0,0,0,0,0,0,0,0,0,0,0,0,0,0,30],
    [30,259,0,0,0,0,0,0,0,0,0,0,0,0,0,0,0,0,0,0,0,0,0,0,30],
    [30,30,30,30,30,30,482,30,30,30,30,30,482,30,30,30,30,30,482,30,30,30,30,30,30]
  ],
  "colisiones": [
    [1,1,1,1,1,1,1,1,1,1,1,1,1,1,1,1,1,1,1,1,1,1,1,1,1],
    [1,1,0,0,0,0,0,0,0,0,0,0,0,0,0,0,0,0,0,0,0,0,0,0,1],
    [1,1,0,0,1,0,0,0,0,1,0,0,0,0,1,0,0,0,0,1,0,0,0,0,1],
    [1,0,0,1,1,0,0,0,1,1,0,0,0,1,1,0,0,0,1,1,0,0,0,0,1],
    [1,0,0,0,1,0,0,0,0,1,0,0,0,0,1,0,0,0,0,1,0,0,0,0,1],
    [1,0,0,0,0,0,0,0,0,0,0,0,0,0,0,0,0,0,0,0,0,0,0,0,1],
    [1,0,0,0,0,0,0,0,0,0,0,0,0,0,0,0,0,0,0,0,0,0,0,0,1],
    [1,0,0,0,1,0,0,0,0,1,0,0,0,0,1,0,0,0,0,1,0,0,0,0,1],
    [1,0,0,1,1,0,0,0,1,1,0,0,0,1,1,0,0,0,1,1,0,0,0,0,1],
    [1,0,0,0,1,0,0,0,0,1,0,0,0,0,1,0,0,0,0,1,0,0,0,0,1],
    [1,0,0,0,0,0,0,0,0,0,0,0,0,0,0,0,0,0,0,0,0,0,0,0,1],
    [1,0,0,0,0,0,0,0,0,0,0,0,0,0,0,0,0,0,0,0,0,0,0,0,1],
    [1,0,0,0,1,0,0,0,0,1,0,0,0,0,1,0,0,0,0,1,0,0,0,0,1],
    [1,0,0,1,1,0,0,0,1,1,0,0,0,1,1,0,0,0,1,1,0,0,0,0,1],
    [1,0,0,0,1,0,0,0,0,1,0,0,0,0,1,0,0,0,0,1,0,0,0,0,1],
    [1,0,0,0,0,0,0,0,0,0,0,0,0,0,0,0,0,0,0,0,0,0,0,0,1],
    [1,1,0,0,0,0,0,0,0,0,0,0,0,0,0,0,0,0,0,0,0,0,0,0,1],
    [1,1,1,1,1,1,0,1,1,1,1,1,0,1,1,1,1,1,1,1,1,1,1,1,1]
  ],
  "zonas": [
    {
      "x": 1,
      "y": 8,
      "tipo": "url",
      "url": "https://drive.google.com/file/d/16g_9pmcC9jSSJUcV0Vyveyf74ndRkkkT/view?usp=sharing"
    },
    {
      "x": 5,
      "y": 3,
      "tipo": "url",
      "url": "https://drive.google.com/file/d/1D8Y8a5UVLVNHNMwhAMKoiyjLO4MXoVoU/view?usp=sharing"
    },
    {
      "x": 23,
      "y": 1,
      "tipo": "url",
      "url": "https://drive.google.com/file/d/1M35GygR-LzPEkPbiTl0nlp_gv56lY9aS/view?usp=sharing"
    },
     {
      "x": 6,
      "y": 17,
      "tipo": "mapa",
      "destino": "maps/mapa2.json",
      "xInicio": 23,
      "yInicio": 16
    },
    {
      "x": 12,
      "y": 17,
      "tipo": "mapa",
      "destino": "maps/mapa3.json",
      "xInicio": 6,
      "yInicio": 16
    }

  ]
}
