{
  "mapa": [
    [26,127,128,129,130,131,132,133,134,135,136,137,127,128,129,130,131,132,133,134,135,136,137,26,26],
    [26,152,153,154,155,156,157,158,159,160,161,162,152,153,154,155,156,157,158,159,160,161,162,12,26],
    [26,12,12,12,114,12,12,12,12,114,12,12,12,12,114,12,12,12,12,114,12,12,12,12,26],
    [26,12,12,113,120,115,12,12,113,120,115,12,12,113,120,115,12,12,113,120,115,12,12,12,26],
    [26,12,12,12,112,12,12,12,12,112,12,12,12,12,112,12,12,12,12,112,12,12,12,12,26],
    [26,127,128,129,130,131,132,133,134,135,136,137,127,128,129,130,131,132,133,134,135,136,137,12,26],
    [26,152,153,154,155,156,157,158,159,160,161,162,152,153,154,155,156,157,158,159,160,161,162,12,26],
    [26,12,12,12,114,12,12,12,12,114,12,12,12,12,114,12,12,12,12,114,12,12,12,12,26],
    [26,12,12,113,120,115,12,12,113,120,115,12,12,113,120,115,12,12,113,120,115,12,12,12,26],
    [26,12,12,12,112,12,12,12,12,112,12,12,12,12,112,12,12,12,12,112,12,12,12,12,26],
    [26,138,139,12,12,12,12,12,12,12,12,12,12,12,12,12,12,12,12,12,12,12,12,12,26],
    [26,163,164,12,12,12,12,12,12,12,12,12,12,12,12,12,12,12,12,12,12,12,12,12,26],
    [26,188,189,12,12,12,12,12,12,114,12,12,12,12,114,12,12,12,12,114,12,12,12,12,26],
    [26,143,144,145,12,12,12,12,113,120,115,12,12,113,120,115,12,12,113,120,115,12,12,12,26],
    [26,168,169,170,12,12,12,12,12,112,12,12,12,12,112,12,12,12,12,112,12,12,12,12,26],
    [26,193,194,195,12,12,12,12,12,12,12,12,12,12,12,12,12,12,12,12,12,12,12,12,26],
    [26,218,219,220,12,12,12,12,12,12,12,12,12,12,12,12,12,12,12,12,12,12,12,12,26],
    [26,26,26,26,26,26,26,26,26,26,26,26,26,26,26,26,26,26,26,26,26,26,26,482,26]
  ],
  "colisiones": [
    [1,1,1,1,1,1,1,1,1,1,1,1,1,1,1,1,1,1,1,1,1,1,1,1,1],
    [1,0,0,0,0,0,0,0,0,0,0,0,0,0,0,0,0,0,0,0,0,0,0,0,1],
    [1,0,0,0,1,0,0,0,0,1,0,0,0,0,1,0,0,0,0,1,0,0,0,0,1],
    [1,0,0,1,1,1,0,0,1,1,1,0,0,1,1,1,0,0,1,1,1,0,0,0,1],
    [1,0,0,0,1,0,0,0,0,1,0,0,0,0,1,0,0,0,0,1,0,0,0,0,1],
    [1,1,1,1,1,1,1,1,1,1,1,1,1,1,1,1,1,1,1,1,1,1,1,0,1],
    [1,0,0,0,0,0,0,0,0,0,0,0,0,0,0,0,0,0,0,0,0,0,0,0,1],
    [1,0,0,0,1,0,0,0,0,1,0,0,0,0,1,0,0,0,0,1,0,0,0,0,1],
    [1,0,0,1,1,1,0,0,1,1,1,0,0,1,1,1,0,0,1,1,1,0,0,0,1],
    [1,0,0,0,1,0,0,0,0,1,0,0,0,0,1,0,0,0,0,1,0,0,0,0,1],
    [1,0,0,0,0,0,0,0,0,0,0,0,0,0,0,0,0,0,0,0,0,0,0,0,1],
    [1,0,0,0,0,0,0,0,0,0,0,0,0,0,0,0,0,0,0,0,0,0,0,0,1],
    [1,0,0,0,0,0,0,0,0,1,0,0,0,0,1,0,0,0,0,1,0,0,0,0,1],
    [1,0,0,0,0,0,0,0,1,1,1,0,0,1,1,1,0,0,1,1,1,0,0,0,1],
    [1,0,0,0,0,0,0,0,0,1,0,0,0,0,1,0,0,0,0,1,0,0,0,0,1],
    [1,0,0,0,0,0,0,0,0,0,0,0,0,0,0,0,0,0,0,0,0,0,0,0,1],
    [1,0,0,0,0,0,0,0,0,0,0,0,0,0,0,0,0,0,0,0,0,0,0,0,1],
    [1,1,1,1,1,1,1,1,1,1,1,1,1,1,1,1,1,1,1,1,1,1,1,0,1]
    ],

"zonas": [
    { "x": 1, "y": 12,"tipo": "url", "url": "https://pablolu2024.github.io/Biblioteca/" },
    {
      "x": 23,
      "y": 17,
      "tipo": "mapa",
      "destino": "maps/mapa1.json",
      "xInicio": 6,
      "yInicio": 16
    }
    
  ]

}